XXXXXXXXXXXXXXXXXXXXX
XXXXXoXXoXXXXXoXXXXXX
XXXXX XX   G   XXXXXX
XXXXX XX XX#XX XXXXXX
XXXXX XX#XoooX XXXXXX
XXXXX XXo      #oXXXX
X              #oXXXX
X oooo    XXXX      X
X               #oX X
X XXXo          #oX X
X XXX#oo##ooooX XXX X
X  XX XX XX#XXX X   X
XX XX XX   G    X XXX
XX XXoXXoXXXXXXoXoXXX
Xo   #  #      #  oXX
XX XX XX XXXXXX   #XX
XX                oXX
XX XXXXXXXXXXXXXXGXXX
XXsXXXXXXXXXXXXXXXXXX

